1111111111111111111111
100000C000000000000001
101111000111111C000001
100C010001110000000001
1P0000C0000011000000E1
1111111111111111111111