1111111111111111111111
1000000000000000000001
1011110001111110000001
1000010001110000000001
100000000000110000CPE1
1111111111111111111111