1111111111111111111111
1000000000000000000001
1011110001111110000001
10000100011100000E0001
000000000000110000CP01
1111111111111111111111