111111111
1PE000C01
100000001
111111111