1111111111111111111111
10C0000000000000000001
1011110001111110000001
10C00100011100000E0001
1000C0000000110000CP01
1111111111111111111111
