1111111111111111111111
100000C000000000000001
101111000111111C000001
100C01000111000000PP01
100000C0000011000000E1
1111111111111111111111